,Game,AppID,Review Score,Positive Reviews,Negative Reviews,Review Score Description,Total Review,Units Sold (Estimated),Engine
0,english country tune,207570,8,134,9,Very Positive,143,2860,Unity Engine
1,rwby: grimm eclipse,418340,8,7948,1771,Very Positive,9719,194380,Unity Engine
2,pc building simulator,621060,8,34174,2049,Very Positive,36223,724460,Unity Engine
3,green hell,815370,8,32644,4649,Very Positive,37293,745860,Unity Engine
4,mini metro,287980,9,9015,357,Overwhelmingly Positive,9372,187440,Unity Engine
5,aegis of earth: protonovus assault,450250,5,24,14,Mixed,38,760,Unity Engine
6,the bunker,481110,5,811,359,Mixed,1170,23400,Unity Engine
7,rick and morty: virtual rick-ality,469610,6,1308,415,Mostly Positive,1723,34460,Unity Engine
8,disco elysium,632470,8,54811,3411,Very Positive,58222,1164440,Unity Engine
9,rust,252490,8,592170,86780,Very Positive,678950,13579000,Unity Engine
10,tannenberg,633460,8,5716,860,Very Positive,6576,131520,Unity Engine
11,fox n forests,603400,6,90,24,Mostly Positive,114,2280,Unity Engine
12,i am bread,327890,6,3534,990,Mostly Positive,4524,90480,Unity Engine
13,west of loathing,597220,9,7013,167,Overwhelmingly Positive,7180,143600,Unity Engine
14,night in the woods,481510,8,11490,680,Very Positive,12170,243400,Unity Engine
15,parkitect,453090,8,4729,296,Very Positive,5025,100500,Unity Engine
16,nickelodeon all-star brawl,1414850,6,3223,829,Mostly Positive,4052,81040,Unity Engine
17,cities: skylines,255710,8,143774,10305,Very Positive,154079,3081580,Unity Engine
18,atlas reactor,402570,8,1225,133,Very Positive,1358,27160,Unity Engine
19,arma tactics,224860,4,116,240,Mostly Negative,356,7120,Unity Engine
20,pillars of eternity,291650,8,11703,1691,Very Positive,13394,267880,Unity Engine
21,secret agent hd,1607670,8,97,1,Very Positive,98,1960,Unity Engine
22,cobra kai: the karate kid saga continues,1279920,8,249,38,Very Positive,287,5740,Unity Engine
23,screencheat,301970,8,603,55,Very Positive,658,13160,Unity Engine
24,dream daddy: a dad dating simulator,654880,8,4198,379,Very Positive,4577,91540,Unity Engine
25,motorsport manager,415200,8,8697,817,Very Positive,9514,190280,Unity Engine
26,nascar heat 5,1265860,8,1296,273,Very Positive,1569,31380,Unity Engine
27,dreadout,269790,6,2840,861,Mostly Positive,3701,74020,Unity Engine
28,lara croft go,540840,8,2181,139,Very Positive,2320,46400,Unity Engine
29,among the sleep,250620,8,4054,546,Very Positive,4600,92000,Unity Engine
30,the world next door,755470,8,143,31,Very Positive,174,3480,Unity Engine
31,catlateral damage,329860,8,817,100,Very Positive,917,18340,Unity Engine
32,rec room,471710,8,113,1,Very Positive,114,2280,Unity Engine
33,final fantasy ix,377840,8,7170,438,Very Positive,7608,152160,Unity Engine
34,cooking simulator,641320,8,11053,2061,Very Positive,13114,262280,Unity Engine
35,huniepop,339800,9,22211,818,Overwhelmingly Positive,23029,460580,Unity Engine
36,life is strange: before the storm,554620,8,29428,2189,Very Positive,31617,632340,Unity Engine
37,stories untold,558420,8,2927,446,Very Positive,3373,67460,Unity Engine
38,totally accurate battle simulator,508440,9,86256,1739,Overwhelmingly Positive,87995,1759900,Unity Engine
39,nascar heat 4,1127980,8,935,190,Very Positive,1125,22500,Unity Engine
40,trollhunters: defenders of arcadia,1344070,6,29,8,Mostly Positive,37,740,Unity Engine
41,manifold garden,473950,9,3449,130,Overwhelmingly Positive,3579,71580,Unity Engine
42,twelve minutes,1097200,6,4058,1475,Mostly Positive,5533,110660,Unity Engine
43,jack move,1099640,8,247,52,Very Positive,299,5980,Unity Engine
44,ultrakill,1229490,9,35302,451,Overwhelmingly Positive,35753,715060,Unity Engine
45,syndrome,409320,5,132,62,Mixed,194,3880,Unity Engine
46,inside,304430,9,34440,1213,Overwhelmingly Positive,35653,713060,Unity Engine
47,zombieland: double tap - road trip,995430,5,15,10,Mixed,25,500,Unity Engine
48,orwell,491950,8,6901,645,Very Positive,7546,150920,Unity Engine
49,furi,423230,8,7134,645,Very Positive,7779,155580,Unity Engine
50,p.a.m.e.l.a.,427880,5,484,303,Mixed,787,15740,Unity Engine
51,yiik: a postmodern rpg,459080,5,241,114,Mixed,355,7100,Unity Engine
52,7 days to die,251570,8,142842,18444,Very Positive,161286,3225720,Unity Engine
53,year walk,269050,8,1079,84,Very Positive,1163,23260,Unity Engine
54,super animal royale,843380,9,6139,296,Overwhelmingly Positive,6435,128700,Unity Engine
55,cities in motion 2,225420,5,675,446,Mixed,1121,22420,Unity Engine
56,dead effect,286040,6,1960,753,Mostly Positive,2713,54260,Unity Engine
57,umurangi generation,1223500,8,651,49,Very Positive,700,14000,Unity Engine
58,black skylands,1143810,8,814,112,Very Positive,926,18520,Unity Engine
59,hero of many,297370,8,59,8,Very Positive,67,1340,Unity Engine
60,v rising,1604030,8,38358,5019,Very Positive,43377,867540,Unity Engine
61,her story,368370,8,5621,641,Very Positive,6262,125240,Unity Engine
62,"dr. langeskov, the tiger, and the terribly cursed emerald: a whirlwind heist",409160,8,151,7,Very Positive,158,3160,Unity Engine
63,graveyard keeper,599140,8,19318,3106,Very Positive,22424,448480,Unity Engine
64,realmyst: masterpiece edition,244430,8,1015,133,Very Positive,1148,22960,Unity Engine
65,poi,401810,8,351,24,Very Positive,375,7500,Unity Engine
66,djmax respect v,960170,8,14899,2176,Very Positive,17075,341500,Unity Engine
67,tis-100,370360,9,2771,69,Overwhelmingly Positive,2840,56800,Unity Engine
68,sands of salzaar,1094520,8,15290,2886,Very Positive,18176,363520,Unity Engine
69,tunic,553420,8,4578,373,Very Positive,4951,99020,Unity Engine
70,hand of fate,266510,8,6863,755,Very Positive,7618,152360,Unity Engine
71,teslagrad,249590,8,1320,233,Very Positive,1553,31060,Unity Engine
72,necropolis,384490,5,2317,1319,Mixed,3636,72720,Unity Engine
73,white day: a labyrinth named school,466130,6,1285,340,Mostly Positive,1625,32500,Unity Engine
74,naraka: bladepoint,1203220,6,91104,24399,Mostly Positive,115503,2310060,Unity Engine
75,trailmakers,585420,8,10584,829,Very Positive,11413,228260,Unity Engine
76,crying suns,873940,8,2108,336,Very Positive,2444,48880,Unity Engine
77,armello,290340,8,8325,1770,Very Positive,10095,201900,Unity Engine
78,thronebreaker: the witcher tales,973760,8,10969,1227,Very Positive,12196,243920,Unity Engine
79,phasmophobia,739630,9,383402,11497,Overwhelmingly Positive,394899,7897980,Unity Engine
80,guns and robots,293540,4,5,10,Mostly Negative,15,300,Unity Engine
81,the elder scrolls: legends,364470,0,0,0,No user reviews,0,0,Unity Engine
82,islanders,1046030,9,13061,664,Overwhelmingly Positive,13725,274500,Unity Engine
83,the last night,612400,0,0,0,No user reviews,0,0,Unity Engine
84,shroud of the avatar: forsaken virtues,326160,5,502,463,Mixed,965,19300,Unity Engine
85,digimon survive,871980,8,1510,340,Very Positive,1850,37000,Unity Engine
86,glittermitten grove,536890,8,259,52,Very Positive,311,6220,Unity Engine
87,house party,611790,8,9921,1392,Very Positive,11313,226260,Unity Engine
88,aaero,499890,8,269,21,Very Positive,290,5800,Unity Engine
89,klonoa phantasy reverie series,1730680,9,796,21,Overwhelmingly Positive,817,16340,Unity Engine
90,the long dark,305620,8,73799,6419,Very Positive,80218,1604360,Unity Engine
91,victory at sea,298480,6,337,117,Mostly Positive,454,9080,Unity Engine
92,iron harvest,826630,6,5820,2026,Mostly Positive,7846,156920,Unity Engine
93,pathologic 2,505230,8,5441,420,Very Positive,5861,117220,Unity Engine
94,aragami,280160,8,7778,814,Very Positive,8592,171840,Unity Engine
95,dex,269650,8,2159,327,Very Positive,2486,49720,Unity Engine
96,human: fall flat,477160,8,123460,7054,Very Positive,130514,2610280,Unity Engine
97,the dwarves,403970,6,737,253,Mostly Positive,990,19800,Unity Engine
98,cloudpunk,746850,8,9116,1084,Very Positive,10200,204000,Unity Engine
99,gunfire reborn,1217060,8,64132,3753,Very Positive,67885,1357700,Unity Engine
100,desperados iii,610370,9,7003,223,Overwhelmingly Positive,7226,144520,Unity Engine
101,shadow blade: reload,272330,8,146,20,Very Positive,166,3320,Unity Engine
102,doom,379720,9,107376,5195,Overwhelmingly Positive,112571,2251420,Unity Engine
103,dusk,519860,9,14485,308,Overwhelmingly Positive,14793,295860,Unity Engine
104,nascar heat evolution,508450,5,153,136,Mixed,289,5780,Unity Engine
105,the lab,450390,8,212,14,Very Positive,226,4520,Unity Engine
106,dawn of the monsters,1642170,8,58,5,Very Positive,63,1260,Unity Engine
107,slime rancher 2,1657630,9,9752,482,Overwhelmingly Positive,10234,204680,Unity Engine
108,action taimanin,1335200,0,0,0,No user reviews,0,0,Unity Engine
109,infinifactory,300570,8,1520,81,Very Positive,1601,32020,Unity Engine
110,yestermorrow,1210490,5,24,11,Mixed,35,700,Unity Engine
111,tyranny,362960,8,7159,1072,Very Positive,8231,164620,Unity Engine
112,pony island,405640,9,9697,453,Overwhelmingly Positive,10150,203000,Unity Engine
113,just shapes & beats,531510,9,13911,305,Overwhelmingly Positive,14216,284320,Unity Engine
114,monument valley 2,1927740,8,302,15,Very Positive,317,6340,Unity Engine
115,helltaker,1289310,8,366,4,Very Positive,370,7400,Unity Engine
116,interstellar marines,236370,5,2285,1918,Mixed,4203,84060,Unity Engine
117,car mechanic simulator 2015,320300,8,10691,913,Very Positive,11604,232080,Unity Engine
118,legend of dungeon,238280,6,863,313,Mostly Positive,1176,23520,Unity Engine
119,the last tinker: city of colors,260160,6,484,138,Mostly Positive,622,12440,Unity Engine
120,double dragon iv,528610,5,390,236,Mixed,626,12520,Unity Engine
121,void bastards,857980,8,2897,415,Very Positive,3312,66240,Unity Engine
122,lost sphear,525240,5,78,64,Mixed,142,2840,Unity Engine
123,everhood,1229380,9,7443,286,Overwhelmingly Positive,7729,154580,Unity Engine
124,ziggurat,308420,8,2367,333,Very Positive,2700,54000,Unity Engine
125,bendy and the ink machine,622650,8,8703,1034,Very Positive,9737,194740,Unity Engine
126,a valley without wind,209330,5,115,70,Mixed,185,3700,Unity Engine
127,clustertruck,397950,8,9032,634,Very Positive,9666,193320,Unity Engine
128,pga tour 2k23,1588010,5,156,89,Mixed,245,4900,Unity Engine
129,big pharma,344850,6,1013,294,Mostly Positive,1307,26140,Unity Engine
130,uberstrike,291210,0,0,0,No user reviews,0,0,Unity Engine
131,i hate running backwards,575820,6,120,41,Mostly Positive,161,3220,Unity Engine
132,heavy bullets,297120,8,935,200,Very Positive,1135,22700,Unity Engine
133,tattletail,568090,8,2495,171,Very Positive,2666,53320,Unity Engine
134,little misfortune,714120,8,4385,491,Very Positive,4876,97520,Unity Engine
135,fract osc,243220,8,328,57,Very Positive,385,7700,Unity Engine
136,badiya,545050,5,145,122,Mixed,267,5340,Unity Engine
137,space pirate trainer,418650,8,2402,129,Very Positive,2531,50620,Unity Engine
138,totally accurate battlegrounds,823130,8,13769,1792,Very Positive,15561,311220,Unity Engine
139,fe,1225580,8,230,33,Very Positive,263,5260,Unity Engine
140,rimworld,294100,9,116771,2056,Overwhelmingly Positive,118827,2376540,Unity Engine
141,gwent: the witcher card game,1284410,0,0,0,No user reviews,0,0,Unity Engine
142,darkwood,274520,8,11637,644,Very Positive,12281,245620,Unity Engine
143,ori and the will of the wisps,1057090,9,82306,2979,Overwhelmingly Positive,85285,1705700,Unity Engine
144,gtfo,493520,8,25932,3830,Very Positive,29762,595240,Unity Engine
145,max: the curse of brotherhood,255390,8,1137,63,Very Positive,1200,24000,Unity Engine
146,runner3,516130,6,160,48,Mostly Positive,208,4160,Unity Engine
147,inscryption,1092790,9,69837,2040,Overwhelmingly Positive,71877,1437540,Unity Engine
148,sword coast legends,325600,5,1224,867,Mixed,2091,41820,Unity Engine
149,ylands,298610,5,2137,1446,Mixed,3583,71660,Unity Engine
150,electronic super joy,244870,8,2280,248,Very Positive,2528,50560,Unity Engine
151,yooka-laylee,360830,6,1866,487,Mostly Positive,2353,47060,Unity Engine
152,punch club,394310,8,6940,1488,Very Positive,8428,168560,Unity Engine
153,far: lone sails,609320,8,9837,601,Very Positive,10438,208760,Unity Engine
154,outer wilds,753640,9,35332,1702,Overwhelmingly Positive,37034,740680,Unity Engine
155,i am setsuna,441830,6,937,352,Mostly Positive,1289,25780,Unity Engine
156,umbrella corps,390340,4,338,608,Mostly Negative,946,18920,Unity Engine
157,house flipper,613100,8,55093,3859,Very Positive,58952,1179040,Unity Engine
158,verdun,242860,8,24047,3443,Very Positive,27490,549800,Unity Engine
159,wizard of legend,445980,8,12496,1114,Very Positive,13610,272200,Unity Engine
160,raft,648800,8,169156,11831,Very Positive,180987,3619740,Unity Engine
161,empyrion - galactic survival,383120,8,19898,4683,Very Positive,24581,491620,Unity Engine
162,dropsy,274350,8,1162,69,Very Positive,1231,24620,Unity Engine
163,superliminal,1049410,8,14956,812,Very Positive,15768,315360,Unity Engine
164,armikrog,334120,5,600,399,Mixed,999,19980,Unity Engine
165,tanki x,607200,0,2,0,2 user reviews,2,40,Unity Engine
166,black book,1138660,8,3201,191,Very Positive,3392,67840,Unity Engine
167,two point hospital,535930,8,19999,1646,Very Positive,21645,432900,Unity Engine
168,adventure time: pirates of the enchiridion,728240,8,358,45,Very Positive,403,8060,Unity Engine
169,battletech,637090,8,15023,3118,Very Positive,18141,362820,Unity Engine
170,osiris: new dawn,402710,5,7066,4437,Mixed,11503,230060,Unity Engine
171,thomas was alone,220780,8,3454,249,Very Positive,3703,74060,Unity Engine
172,children of morta,330020,8,10022,1013,Very Positive,11035,220700,Unity Engine
173,tony stewart's sprint car racing,1240230,8,161,22,Very Positive,183,3660,Unity Engine
174,my time at portia,666140,8,27685,2169,Very Positive,29854,597080,Unity Engine
175,gorogoa,557600,9,11281,304,Overwhelmingly Positive,11585,231700,Unity Engine
176,yooka-laylee and the impossible lair,846870,8,461,53,Very Positive,514,10280,Unity Engine
177,war robots,767560,0,0,0,No user reviews,0,0,Unity Engine
178,neo: the world ends with you,1647550,8,63,1,Very Positive,64,1280,Unity Engine
179,war for the overworld,230190,8,4778,783,Very Positive,5561,111220,Unity Engine
180,corpse party: blood drive,824830,8,190,35,Very Positive,225,4500,Unity Engine
181,saurian,587450,5,797,438,Mixed,1235,24700,Unity Engine
182,crystal caves hd,1330890,8,213,2,Very Positive,215,4300,Unity Engine
183,pewdiepie: legend of the brofist,390520,8,1070,103,Very Positive,1173,23460,Unity Engine
184,wasteland 2,240760,8,3750,807,Very Positive,4557,91140,Unity Engine
185,katamari damacy reroll,848350,8,2916,226,Very Positive,3142,62840,Unity Engine
186,escape plan,417600,0,0,0,No user reviews,0,0,Unity Engine
187,death's door,894020,8,10111,639,Very Positive,10750,215000,Unity Engine
188,jungle rumble,1608210,0,2,1,3 user reviews,3,60,Unity Engine
189,hot lava,382560,8,3768,270,Very Positive,4038,80760,Unity Engine
190,gris,683320,9,48545,1616,Overwhelmingly Positive,50161,1003220,Unity Engine
191,albion online,761890,6,1286,486,Mostly Positive,1772,35440,Unity Engine
192,pac-man world re-pac,1859470,8,293,13,Very Positive,306,6120,Unity Engine
193,forced,249990,6,1298,444,Mostly Positive,1742,34840,Unity Engine
194,"sir, you are being hunted",242880,6,2263,577,Mostly Positive,2840,56800,Unity Engine
195,slender: the arrival,252330,8,5376,726,Very Positive,6102,122040,Unity Engine
196,dungeons 2,262280,6,1616,457,Mostly Positive,2073,41460,Unity Engine
197,big buck hunter arcade,455700,5,29,15,Mixed,44,880,Unity Engine
198,little witch academia: chamber of time,710470,6,722,208,Mostly Positive,930,18600,Unity Engine
199,star trek timelines,600750,0,3,1,4 user reviews,4,80,Unity Engine
200,dead effect 2,394760,6,1221,464,Mostly Positive,1685,33700,Unity Engine
201,subnautica,264710,9,179503,6616,Overwhelmingly Positive,186119,3722380,Unity Engine
202,shadowverse,453480,8,290,66,Very Positive,356,7120,Unity Engine
203,boneworks,823500,8,27660,2325,Very Positive,29985,599700,Unity Engine
204,untitled goose game,837470,9,10201,424,Overwhelmingly Positive,10625,212500,Unity Engine
205,rune factory 5,1702330,8,579,136,Very Positive,715,14300,Unity Engine
206,tabletop simulator,286160,9,31328,1293,Overwhelmingly Positive,32621,652420,Unity Engine
207,"that dragon, cancer",419460,8,1041,115,Very Positive,1156,23120,Unity Engine
208,the novelist,245150,6,417,112,Mostly Positive,529,10580,Unity Engine
209,frog fractions: game of the decade edition,1194840,8,70,0,Very Positive,70,1400,Unity Engine
210,fall guys,1097150,8,338905,75042,Very Positive,413947,8278940,Unity Engine
211,homeworld: deserts of kharak,281610,8,4928,1018,Very Positive,5946,118920,Unity Engine
212,atom rpg,552620,8,6737,872,Very Positive,7609,152180,Unity Engine
213,superhot,322500,8,18815,1974,Very Positive,20789,415780,Unity Engine
214,power rangers: battle for the grid,1110100,8,904,121,Very Positive,1025,20500,Unity Engine
215,oxenfree,388880,8,7379,593,Very Positive,7972,159440,Unity Engine
216,flotsam,821250,6,1543,524,Mostly Positive,2067,41340,Unity Engine
217,fractal,566180,0,2,3,5 user reviews,5,100,Unity Engine
218,super monkey ball: banana blitz hd,1061730,5,150,112,Mixed,262,5240,Unity Engine
219,forgotton anne,542050,8,1098,105,Very Positive,1203,24060,Unity Engine
220,chaos reborn,319050,6,592,194,Mostly Positive,786,15720,Unity Engine
221,rollercoaster tycoon world,282560,4,766,2252,Mostly Negative,3018,60360,Unity Engine
222,freedom planet 2,595500,9,673,27,Overwhelmingly Positive,700,14000,Unity Engine
223,return of the obra dinn,653530,9,15585,518,Overwhelmingly Positive,16103,322060,Unity Engine
224,grow home,323320,8,3237,242,Very Positive,3479,69580,Unity Engine
225,space hulk,242570,6,1051,442,Mostly Positive,1493,29860,Unity Engine
226,florence,1102130,8,6714,470,Very Positive,7184,143680,Unity Engine
227,the bridge,204240,8,2749,357,Very Positive,3106,62120,Unity Engine
228,moebius: empire rising,264520,6,108,30,Mostly Positive,138,2760,Unity Engine
229,crayola scoot,772530,6,23,8,Mostly Positive,31,620,Unity Engine
230,ghost of a tale,417290,8,3034,264,Very Positive,3298,65960,Unity Engine
231,temtem,745920,8,24347,4422,Very Positive,28769,575380,Unity Engine
232,guns of icarus online,82060,0,0,0,No user reviews,0,0,Unity Engine
233,defunct,359350,8,404,91,Very Positive,495,9900,Unity Engine
234,layers of fear,391720,8,9998,1031,Very Positive,11029,220580,Unity Engine
235,doki doki literature club plus!,1388880,9,15552,524,Overwhelmingly Positive,16076,321520,Unity Engine
236,streets of rogue,512900,9,11909,426,Overwhelmingly Positive,12335,246700,Unity Engine
237,140,242820,8,1738,102,Very Positive,1840,36800,Unity Engine
238,adventures of pip,303550,8,122,20,Very Positive,142,2840,Unity Engine
239,there is no game: wrong dimension,1240210,9,15858,326,Overwhelmingly Positive,16184,323680,Unity Engine
240,paw patrol: on a roll,758730,8,211,37,Very Positive,248,4960,Unity Engine
241,hellpoint,628670,6,1647,450,Mostly Positive,2097,41940,Unity Engine
242,assault android cactus,250110,8,1102,59,Very Positive,1161,23220,Unity Engine
243,super bomberman r,702700,5,191,152,Mixed,343,6860,Unity Engine
244,in other waters,890720,8,944,89,Very Positive,1033,20660,Unity Engine
245,torment: tides of numenera,272270,6,1257,499,Mostly Positive,1756,35120,Unity Engine
246,lifeless planet,261530,6,1800,515,Mostly Positive,2315,46300,Unity Engine
247,paralives,1118520,0,0,0,No user reviews,0,0,Unity Engine
248,project hospital,868360,8,4700,640,Very Positive,5340,106800,Unity Engine
249,death squared,471810,8,296,24,Very Positive,320,6400,Unity Engine
250,stranded deep,313120,6,25962,8290,Mostly Positive,34252,685040,Unity Engine
251,slime rancher,433340,9,85028,1807,Overwhelmingly Positive,86835,1736700,Unity Engine
252,transformers: battlegrounds,1177000,7,40,7,Positive,47,940,Unity Engine
253,sairento vr,555880,8,1199,172,Very Positive,1371,27420,Unity Engine
254,deus ex: the fall,258180,4,1161,2064,Mostly Negative,3225,64500,Unity Engine
255,alba: a wildlife adventure,1337010,9,2879,61,Overwhelmingly Positive,2940,58800,Unity Engine
256,dungeons 3,493900,8,10776,658,Very Positive,11434,228680,Unity Engine
257,plague inc: evolved,246620,8,37772,2208,Very Positive,39980,799600,Unity Engine
258,dreamfall chapters,237850,8,2434,509,Very Positive,2943,58860,Unity Engine
259,ape out,447150,8,2069,127,Very Positive,2196,43920,Unity Engine
260,donut county,702670,8,5604,613,Very Positive,6217,124340,Unity Engine
261,wasteland 3,719040,8,10401,1968,Very Positive,12369,247380,Unity Engine
262,kentucky route zero,231200,8,1873,392,Very Positive,2265,45300,Unity Engine
263,crab game,1782210,0,0,0,No user reviews,0,0,Unity Engine
264,oxygen not included,457140,9,80317,2892,Overwhelmingly Positive,83209,1664180,Unity Engine
265,besiege,346010,9,38177,1739,Overwhelmingly Positive,39916,798320,Unity Engine
266,the silver case,476650,8,402,67,Very Positive,469,9380,Unity Engine
267,deemo -reborn-,1282210,8,2443,337,Very Positive,2780,55600,Unity Engine
268,the room,288160,9,19854,458,Overwhelmingly Positive,20312,406240,Unity Engine
269,valley,378610,8,5366,499,Very Positive,5865,117300,Unity Engine
270,ooblets,593150,0,0,0,No user reviews,0,0,Unity Engine
271,super lucky's tale,847360,8,316,54,Very Positive,370,7400,Unity Engine
272,everything,582270,8,2309,442,Very Positive,2751,55020,Unity Engine
273,shellshock live,326460,8,23891,1602,Very Positive,25493,509860,Unity Engine
274,pathfinder: kingmaker,640820,6,17612,4866,Mostly Positive,22478,449560,Unity Engine
275,pillars of eternity ii: deadfire,560130,8,9503,1413,Very Positive,10916,218320,Unity Engine
276,sylvio,362860,6,83,26,Mostly Positive,109,2180,Unity Engine
277,firewatch,383870,8,48232,6205,Very Positive,54437,1088740,Unity Engine
278,vrchat,438100,8,126,25,Very Positive,151,3020,Unity Engine
279,the forest,242760,9,327897,16141,Overwhelmingly Positive,344038,6880760,Unity Engine
280,broforce,274190,9,39041,1161,Overwhelmingly Positive,40202,804040,Unity Engine
281,kairo,233230,6,1076,373,Mostly Positive,1449,28980,Unity Engine
282,phoenix point,839770,6,2472,934,Mostly Positive,3406,68120,Unity Engine
283,organ trail: director's cut,233740,8,1915,215,Very Positive,2130,42600,Unity Engine
284,the mummy demastered,630310,8,328,75,Very Positive,403,8060,Unity Engine
285,pikuniku,572890,9,4685,189,Overwhelmingly Positive,4874,97480,Unity Engine
286,battletoads,1244950,5,1090,471,Mixed,1561,31220,Unity Engine
287,the room two,425580,9,14144,312,Overwhelmingly Positive,14456,289120,Unity Engine
288,unturned,304930,8,6979,729,Very Positive,7708,154160,Unity Engine
289,sudden strike 4,373930,6,3915,1165,Mostly Positive,5080,101600,Unity Engine
290,knights and bikes,592480,8,270,23,Very Positive,293,5860,Unity Engine
291,outward,794260,6,12168,4210,Mostly Positive,16378,327560,Unity Engine
292,sunless sea,304650,8,5643,1058,Very Positive,6701,134020,Unity Engine
293,ultimate chicken horse,386940,9,22283,791,Overwhelmingly Positive,23074,461480,Unity Engine
294,hardspace: shipbreaker,1161580,8,11549,1401,Very Positive,12950,259000,Unity Engine
295,uboat,494840,8,10619,2519,Very Positive,13138,262760,Unity Engine
296,shadow tactics: blades of the shogun,418240,9,24963,968,Overwhelmingly Positive,25931,518620,Unity Engine
297,hollow knight: silksong,1030300,0,0,0,No user reviews,0,0,Unity Engine
298,aegis defenders,371140,6,106,31,Mostly Positive,137,2740,Unity Engine
299,observation,906100,6,2694,678,Mostly Positive,3372,67440,Unity Engine
300,robocraft,301520,5,1665,863,Mixed,2528,50560,Unity Engine
301,dear esther: landmark edition,520720,6,1183,323,Mostly Positive,1506,30120,Unity Engine
302,nascar heat 2,670900,5,233,128,Mixed,361,7220,Unity Engine
303,lovers in a dangerous spacetime,252110,8,2530,179,Very Positive,2709,54180,Unity Engine
304,my summer car,516750,8,40252,2651,Very Positive,42903,858060,Unity Engine
305,nascar heat 3,905450,6,316,107,Mostly Positive,423,8460,Unity Engine
306,pga tour 2k21,1016120,8,4168,769,Very Positive,4937,98740,Unity Engine
307,eco,382310,8,6668,1475,Very Positive,8143,162860,Unity Engine
308,cypher,746710,8,492,41,Very Positive,533,10660,Unity Engine
309,descenders,681280,9,9609,444,Overwhelmingly Positive,10053,201060,Unity Engine
310,crawl,293780,9,4444,217,Overwhelmingly Positive,4661,93220,Unity Engine
311,car mechanic simulator 2014,270850,8,3144,688,Very Positive,3832,76640,Unity Engine
312,triple town,209950,8,491,37,Very Positive,528,10560,Unity Engine
313,overload,448850,8,1238,72,Very Positive,1310,26200,Unity Engine
314,monument valley,1927720,9,741,9,Overwhelmingly Positive,750,15000,Unity Engine
315,kerbal space program,220200,9,82574,4202,Overwhelmingly Positive,86776,1735520,Unity Engine
316,subnautica: below zero,848450,8,59194,5641,Very Positive,64835,1296700,Unity Engine
317,river city girls,1049320,8,1760,306,Very Positive,2066,41320,Unity Engine
318,syberia 3,464340,5,1214,1121,Mixed,2335,46700,Unity Engine
319,demon turf,1325900,8,230,29,Very Positive,259,5180,Unity Engine
320,haven,983970,8,2824,229,Very Positive,3053,61060,Unity Engine
321,the stanley parable: ultra deluxe,1703340,8,13680,907,Very Positive,14587,291740,Unity Engine
322,dead secret,402260,8,351,85,Very Positive,436,8720,Unity Engine
323,getting over it with bennett foddy,240720,8,39674,7990,Very Positive,47664,953280,Unity Engine
324,viridi,375950,8,121,11,Very Positive,132,2640,Unity Engine
325,chessaria: the tactical adventure,575340,6,69,21,Mostly Positive,90,1800,Unity Engine
326,praey for the gods,494430,8,1539,275,Very Positive,1814,36280,Unity Engine
327,castle story,227860,5,4557,2577,Mixed,7134,142680,Unity Engine
328,shadowrun returns,234650,8,7722,982,Very Positive,8704,174080,Unity Engine
329,ravenfield,636480,9,49542,1425,Overwhelmingly Positive,50967,1019340,Unity Engine
330,bug fables: the everlasting sapling,1082710,9,3155,67,Overwhelmingly Positive,3222,64440,Unity Engine
331,blues and bullets,378660,5,669,429,Mixed,1098,21960,Unity Engine
332,risk of rain 2,632360,9,138238,4813,Overwhelmingly Positive,143051,2861020,Unity Engine
333,ori and the blind forest,261570,9,39870,1916,Overwhelmingly Positive,41786,835720,Unity Engine
334,shovel knight dig,1416050,6,293,121,Mostly Positive,414,8280,Unity Engine
335,hotel transylvania 3: monsters overboard,757600,6,7,3,Mostly Positive,10,200,Unity Engine
336,tacoma,343860,8,2214,318,Very Positive,2532,50640,Unity Engine
337,bus simulator 16,324310,5,1320,725,Mixed,2045,40900,Unity Engine
338,my friend pedro,557340,9,20486,789,Overwhelmingly Positive,21275,425500,Unity Engine
339,beat saber,620980,9,57225,2319,Overwhelmingly Positive,59544,1190880,Unity Engine
340,sally face,541570,9,11479,342,Overwhelmingly Positive,11821,236420,Unity Engine
341,gone home,232430,6,9422,2815,Mostly Positive,12237,244740,Unity Engine
342,gang beasts,285900,8,28553,6376,Very Positive,34929,698580,Unity Engine
343,hollow knight,367520,9,215763,6132,Overwhelmingly Positive,221895,4437900,Unity Engine
344,poly bridge,367450,8,12094,1078,Very Positive,13172,263440,Unity Engine
345,mother russia bleeds,361300,8,3177,446,Very Positive,3623,72460,Unity Engine
346,valheim,892970,9,298036,14367,Overwhelmingly Positive,312403,6248060,Unity Engine
347,dungeonland,218130,5,206,131,Mixed,337,6740,Unity Engine
348,super monkey ball banana mania,1316910,8,763,103,Very Positive,866,17320,Unity Engine
349,enter the gungeon,311690,9,59286,2418,Overwhelmingly Positive,61704,1234080,Unity Engine
350,blitzkrieg 3,235380,5,2690,2031,Mixed,4721,94420,Unity Engine
351,road 96,1466640,8,8385,748,Very Positive,9133,182660,Unity Engine
352,volume,365770,6,279,71,Mostly Positive,350,7000,Unity Engine
353,among us,945360,8,516793,44055,Very Positive,560848,11216960,Unity Engine
354,cognition: an erica reed thriller,242780,8,277,54,Very Positive,331,6620,Unity Engine
355,bloons td 6,960090,9,182290,4646,Overwhelmingly Positive,186936,3738720,Unity Engine
356,araya,466740,6,487,144,Mostly Positive,631,12620,Unity Engine
357,the book of unwritten tales 2,279940,8,517,54,Very Positive,571,11420,Unity Engine
358,fallout shelter,588430,0,0,0,No user reviews,0,0,Unity Engine
359,overcooked,448510,8,9367,923,Very Positive,10290,205800,Unity Engine
360,cuphead,268910,9,103655,3548,Overwhelmingly Positive,107203,2144060,Unity Engine
361,baldo: the guardian owls,1614890,5,95,55,Mixed,150,3000,Unity Engine
362,scp: secret laboratory,700330,0,0,0,No user reviews,0,0,Unity Engine
363,9 monkeys of shaolin,739080,8,398,62,Very Positive,460,9200,Unreal Engine
364,mictlan: an ancient mythical tale,1411900,0,0,0,No user reviews,0,0,Unreal Engine
365,nemezis: mysterious journey iii,986350,5,52,32,Mixed,84,1680,Unreal Engine
366,tropico 6,492720,8,12749,1839,Very Positive,14588,291760,Unreal Engine
367,warp,102850,5,211,94,Mixed,305,6100,Unreal Engine
368,chernobylite,1016800,8,6480,1282,Very Positive,7762,155240,Unreal Engine
369,tekken 7,389730,8,42153,9580,Very Positive,51733,1034660,Unreal Engine
370,hmmsim metro,1591420,8,783,68,Very Positive,851,17020,Unreal Engine
371,moonbase alpha,39000,8,152,26,Very Positive,178,3560,Unreal Engine
372,rise of the triad,217140,5,1178,566,Mixed,1744,34880,Unreal Engine
373,viscera cleanup detail,246900,8,11752,806,Very Positive,12558,251160,Unreal Engine
374,ashen,649950,6,1650,701,Mostly Positive,2351,47020,Unreal Engine
375,battlefleet gothic: armada,363680,5,3114,1435,Mixed,4549,90980,Unreal Engine
376,gears tactics,1184050,6,4293,1325,Mostly Positive,5618,112360,Unreal Engine
377,rad,722560,6,437,127,Mostly Positive,564,11280,Unreal Engine
378,desert thunder,283330,5,20,14,Mixed,34,680,Unreal Engine
379,life is strange: true colors,936790,8,7427,834,Very Positive,8261,165220,Unreal Engine
380,martha is dead,515960,6,1027,265,Mostly Positive,1292,25840,Unreal Engine
381,destroy all humans!,803330,8,6499,427,Very Positive,6926,138520,Unreal Engine
382,fated: the silent oath,401820,6,70,28,Mostly Positive,98,1960,Unreal Engine
383,gravel,558260,6,421,152,Mostly Positive,573,11460,Unreal Engine
384,close to the sun,968870,6,318,106,Mostly Positive,424,8480,Unreal Engine
385,sherlock holmes: the devil's daughter,350640,8,7983,1995,Very Positive,9978,199560,Unreal Engine
386,poppy playtime,1721470,6,19505,6348,Mostly Positive,25853,517060,Unreal Engine
387,lost planet 3,226720,5,1043,600,Mixed,1643,32860,Unreal Engine
388,styx: shards of darkness,355790,8,2437,476,Very Positive,2913,58260,Unreal Engine
389,bioshock 2,8850,8,8616,1082,Very Positive,9698,193960,Unreal Engine
390,dungeons & dragons: dark alliance,623280,5,1845,1779,Mixed,3624,72480,Unreal Engine
391,deadfall adventures,231330,6,855,297,Mostly Positive,1152,23040,Unreal Engine
392,nerf legends,1279910,4,7,18,Mostly Negative,25,500,Unreal Engine
393,hello neighbor,521890,8,6268,1183,Very Positive,7451,149020,Unreal Engine
394,darksiders genesis,710920,8,6315,1216,Very Positive,7531,150620,Unreal Engine
395,disintegration,536280,5,102,68,Mixed,170,3400,Unreal Engine
396,soulcalibur vi,544750,8,5839,1258,Very Positive,7097,141940,Unreal Engine
397,the occupation,765880,6,98,40,Mostly Positive,138,2760,Unreal Engine
398,darwin project,544920,6,1052,388,Mostly Positive,1440,28800,Unreal Engine
399,kartkraft,406350,8,1544,349,Very Positive,1893,37860,Unreal Engine
400,what remains of edith finch,501300,9,24727,1196,Overwhelmingly Positive,25923,518460,Unreal Engine
401,reaching for petals,636170,6,86,33,Mostly Positive,119,2380,Unreal Engine
402,let it die,794600,0,6,1,7 user reviews,7,140,Unreal Engine
403,mortal shell,1110910,6,2574,908,Mostly Positive,3482,69640,Unreal Engine
404,shenmue iii,878670,6,482,124,Mostly Positive,606,12120,Unreal Engine
405,tales of arise,740130,8,16881,1847,Very Positive,18728,374560,Unreal Engine
406,abzû,384190,8,16655,1228,Very Positive,17883,357660,Unreal Engine
407,the walking dead: saints & sinners,916840,8,5210,656,Very Positive,5866,117320,Unreal Engine
408,ride 3,759740,8,2869,549,Very Positive,3418,68360,Unreal Engine
409,fernbus simulator,427100,5,3626,1624,Mixed,5250,105000,Unreal Engine
410,squad,393380,8,77496,8556,Very Positive,86052,1721040,Unreal Engine
411,barrage,836080,7,36,6,Positive,42,840,Unreal Engine
412,dishonored,205100,9,51211,1373,Overwhelmingly Positive,52584,1051680,Unreal Engine
413,scorn,698670,6,3343,1216,Mostly Positive,4559,91180,Unreal Engine
414,advent rising,3800,8,274,65,Very Positive,339,6780,Unreal Engine
415,amid evil,673130,9,4412,204,Overwhelmingly Positive,4616,92320,Unreal Engine
416,obduction,306760,6,2041,573,Mostly Positive,2614,52280,Unreal Engine
417,satisfactory,526870,9,92198,2574,Overwhelmingly Positive,94772,1895440,Unreal Engine
418,twin mirror,1552810,6,141,44,Mostly Positive,185,3700,Unreal Engine
419,descent,273570,8,361,11,Very Positive,372,7440,Unreal Engine
420,bpm: bullets per minute,1286350,8,7161,538,Very Positive,7699,153980,Unreal Engine
421,crash time iii,33620,8,377,69,Very Positive,446,8920,Unreal Engine
422,the vanishing of ethan carter,258520,8,5670,777,Very Positive,6447,128940,Unreal Engine
423,into the stars,360510,4,146,233,Mostly Negative,379,7580,Unreal Engine
424,psychonauts in the rhombus of ruin,788690,8,347,43,Very Positive,390,7800,Unreal Engine
425,postal redux,401680,8,2596,202,Very Positive,2798,55960,Unreal Engine
426,maneater,629820,8,6796,722,Very Positive,7518,150360,Unreal Engine
427,back 4 blood,924970,5,20098,10658,Mixed,30756,615120,Unreal Engine
428,rising storm 2: vietnam,418460,8,30890,4425,Very Positive,35315,706300,Unreal Engine
429,absolver,473690,6,7651,2865,Mostly Positive,10516,210320,Unreal Engine
430,fishing: barents sea,501080,6,1578,446,Mostly Positive,2024,40480,Unreal Engine
431,the medium,1293160,8,4465,567,Very Positive,5032,100640,Unreal Engine
432,ghostrunner,1139900,8,30149,2598,Very Positive,32747,654940,Unreal Engine
433,terminator: resistance,954740,8,8277,691,Very Positive,8968,179360,Unreal Engine
434,choplifter hd,202070,8,168,23,Very Positive,191,3820,Unreal Engine
435,dirty bomb,333930,8,1087,240,Very Positive,1327,26540,Unreal Engine
436,xenon racer,899390,5,333,182,Mixed,515,10300,Unreal Engine
437,tribes of midgard,858820,6,8421,2510,Mostly Positive,10931,218620,Unreal Engine
438,rime,493200,8,2678,281,Very Positive,2959,59180,Unreal Engine
439,state of mind,437630,6,954,271,Mostly Positive,1225,24500,Unreal Engine
440,grounded,962130,8,26136,3481,Very Positive,29617,592340,Unreal Engine
441,the king of fighters xv,1498570,8,3230,745,Very Positive,3975,79500,Unreal Engine
442,crash force,535690,0,4,1,5 user reviews,5,100,Unreal Engine
443,ancestors legacy,620590,8,3509,822,Very Positive,4331,86620,Unreal Engine
444,sword art online: fatal bullet,626690,8,11088,2747,Very Positive,13835,276700,Unreal Engine
445,necromunda: hired gun,1222370,6,2912,1175,Mostly Positive,4087,81740,Unreal Engine
446,devilian,407510,5,50,39,Mixed,89,1780,Unreal Engine
447,daymare: 1998,842100,6,1464,546,Mostly Positive,2010,40200,Unreal Engine
448,nba 2kvr experience,519490,4,5,11,Mostly Negative,16,320,Unreal Engine
449,unreal ii: the awakening,13200,5,288,129,Mixed,417,8340,Unreal Engine
450,spec ops: the line,50300,8,23073,1539,Very Positive,24612,492240,Unreal Engine
451,chivalry: medieval warfare,219640,8,37770,7661,Very Positive,45431,908620,Unreal Engine
452,perception,426310,6,330,123,Mostly Positive,453,9060,Unreal Engine
453,toxikk,324810,8,1122,210,Very Positive,1332,26640,Unreal Engine
454,xcom 2,268500,8,49713,9312,Very Positive,59025,1180500,Unreal Engine
455,raw data,436320,8,1648,349,Very Positive,1997,39940,Unreal Engine
456,days of war,454350,5,690,677,Mixed,1367,27340,Unreal Engine
457,mirage: arcane warfare,368420,5,270,139,Mixed,409,8180,Unreal Engine
458,aliens: fireteam elite,1549970,8,10946,2463,Very Positive,13409,268180,Unreal Engine
459,torchlight iii,1030210,5,4515,4931,Mixed,9446,188920,Unreal Engine
460,tower of guns,266110,8,403,63,Very Positive,466,9320,Unreal Engine
461,conarium,313780,6,1219,334,Mostly Positive,1553,31060,Unreal Engine
462,worms rumble,1186040,5,874,387,Mixed,1261,25220,Unreal Engine
463,hello neighbor 2,1321680,0,0,0,No user reviews,0,0,Unreal Engine
464,bless online,681660,4,2888,4441,Mostly Negative,7329,146580,Unreal Engine
465,remember me,228300,8,7567,1515,Very Positive,9082,181640,Unreal Engine
466,paladins,444090,8,7639,1542,Very Positive,9181,183620,Unreal Engine
467,almighty: kill your gods,1206600,5,190,84,Mixed,274,5480,Unreal Engine
468,hood: outlaws & legends,927350,5,2763,2459,Mixed,5222,104440,Unreal Engine
469,new gundam breaker,738530,5,676,790,Mixed,1466,29320,Unreal Engine
470,ride to hell: retribution,209340,5,73,62,Mixed,135,2700,Unreal Engine
471,shadow warrior 3,1036890,5,1292,788,Mixed,2080,41600,Unreal Engine
472,project wingman,895870,8,9242,518,Very Positive,9760,195200,Unreal Engine
473,the quarry,1577120,6,2877,842,Mostly Positive,3719,74380,Unreal Engine
474,bios,350600,5,97,59,Mixed,156,3120,Unreal Engine
475,valhalla hills,351910,5,370,239,Mixed,609,12180,Unreal Engine
476,automation,1698690,7,12,3,Positive,15,300,Unreal Engine
477,tom clancy's rainbow six: vegas,13540,6,692,180,Mostly Positive,872,17440,Unreal Engine
478,scarlet nexus,775500,8,7387,1323,Very Positive,8710,174200,Unreal Engine
479,ruiner,464060,8,7540,811,Very Positive,8351,167020,Unreal Engine
480,tom clancy's rainbow six: vegas 2,15120,8,3444,596,Very Positive,4040,80800,Unreal Engine
481,arboria,924070,8,339,74,Very Positive,413,8260,Unreal Engine
482,ether one redux,391920,0,0,0,No user reviews,0,0,Unreal Engine
483,kao the kangaroo,1370140,8,256,58,Very Positive,314,6280,Unreal Engine
484,shadow ops: red mercury,286770,6,126,36,Mostly Positive,162,3240,Unreal Engine
485,the deadly tower of monsters,353700,8,842,103,Very Positive,945,18900,Unreal Engine
486,little nightmares,424840,8,30402,1896,Very Positive,32298,645960,Unreal Engine
487,g.i. joe: operation blackout,1432220,5,27,25,Mixed,52,1040,Unreal Engine
488,mu legend,874240,0,1,8,9 user reviews,9,180,Unreal Engine
489,mirror's edge,17410,8,22128,3162,Very Positive,25290,505800,Unreal Engine
490,state of decay 2,495420,8,27386,5824,Very Positive,33210,664200,Unreal Engine
491,the artful escape,1122680,8,853,61,Very Positive,914,18280,Unreal Engine
492,gemini: heroes reborn,324650,6,254,68,Mostly Positive,322,6440,Unreal Engine
493,sanctum,91600,8,1671,174,Very Positive,1845,36900,Unreal Engine
494,tribes: ascend,17080,5,41,23,Mixed,64,1280,Unreal Engine
495,ghostwire: tokyo,1475810,8,4919,1081,Very Positive,6000,120000,Unreal Engine
496,godfall,928960,5,594,348,Mixed,942,18840,Unreal Engine
497,xcom: chimera squad,882100,6,12986,4875,Mostly Positive,17861,357220,Unreal Engine
498,bioshock infinite,8870,8,89485,5716,Very Positive,95201,1904020,Unreal Engine
499,naruto to boruto: shinobi striker,633230,8,31671,5124,Very Positive,36795,735900,Unreal Engine
500,spongebob squarepants: battle for bikini bottom - rehydrated,969990,9,9617,492,Overwhelmingly Positive,10109,202180,Unreal Engine
501,the flame in the flood,318600,6,1771,585,Mostly Positive,2356,47120,Unreal Engine
502,turning point: fall of liberty,12720,0,0,0,No user reviews,0,0,Unreal Engine
503,tchia,1496590,0,0,0,No user reviews,0,0,Unreal Engine
504,section 8,38229,0,0,0,No user reviews,0,0,Unreal Engine
505,the ball,35460,6,544,182,Mostly Positive,726,14520,Unreal Engine
506,dead by daylight,381210,8,365071,81222,Very Positive,446293,8925860,Unreal Engine
507,five nights at freddy's: help wanted,732690,9,7893,240,Overwhelmingly Positive,8133,162660,Unreal Engine
508,mechwarrior 5: mercenaries,784080,8,4383,828,Very Positive,5211,104220,Unreal Engine
509,vanguard: saga of heroes,24150,0,3,0,3 user reviews,3,60,Unreal Engine
510,hellblade: senua's sacrifice,414340,8,41650,3783,Very Positive,45433,908660,Unreal Engine
511,road rage,499210,5,16,23,Mixed,39,780,Unreal Engine
512,call of the sea,1042490,8,2014,214,Very Positive,2228,44560,Unreal Engine
513,ether one,265950,6,219,75,Mostly Positive,294,5880,Unreal Engine
514,dungeons & dragons: daggerdale,99100,4,72,157,Mostly Negative,229,4580,Unreal Engine
515,ready or not,1144200,8,54452,4187,Very Positive,58639,1172780,Unreal Engine
516,samurai shodown,1342260,6,386,130,Mostly Positive,516,10320,Unreal Engine
517,the outer worlds,578650,8,15443,2649,Very Positive,18092,361840,Unreal Engine
518,daylight,382800,0,1,4,5 user reviews,5,100,Unreal Engine
519,fighting ex layer,871200,8,446,90,Very Positive,536,10720,Unreal Engine
520,mortal kombat x,307780,8,25909,4217,Very Positive,30126,602520,Unreal Engine
521,bleeding edge,1189800,5,966,446,Mixed,1412,28240,Unreal Engine
522,alone in the dark: illumination,275060,4,50,174,Mostly Negative,224,4480,Unreal Engine
523,bloodstained: ritual of the night,692850,8,21985,1225,Very Positive,23210,464200,Unreal Engine
524,ghostbusters,425310,5,16,19,Mixed,35,700,Unreal Engine
525,the mage's tale,766320,6,104,37,Mostly Positive,141,2820,Unreal Engine
526,street outlaws 2: winner takes all,1451950,6,13,5,Mostly Positive,18,360,Unreal Engine
527,it takes two,1426210,9,84202,3482,Overwhelmingly Positive,87684,1753680,Unreal Engine
528,city of brass,301840,6,504,132,Mostly Positive,636,12720,Unreal Engine
529,astroneer,361420,8,76735,6986,Very Positive,83721,1674420,Unreal Engine
530,iron fish,532820,4,5,9,Mostly Negative,14,280,Unreal Engine
531,space hulk: deathwing,298900,5,2622,2199,Mixed,4821,96420,Unreal Engine
532,little nightmares ii,860510,8,17187,914,Very Positive,18101,362020,Unreal Engine
533,bioshock,7670,8,20454,1270,Very Positive,21724,434480,Unreal Engine
534,tom clancy's splinter cell: conviction,33220,6,2140,868,Mostly Positive,3008,60160,Unreal Engine
535,the bureau: xcom declassified,65930,5,2984,1462,Mixed,4446,88920,Unreal Engine
536,marvel vs. capcom: infinite,493840,5,1004,583,Mixed,1587,31740,Unreal Engine
537,h-hour: world's elite,293220,5,414,194,Mixed,608,12160,Unreal Engine
538,red matter,966680,8,602,55,Very Positive,657,13140,Unreal Engine
539,turok,405820,9,2254,116,Overwhelmingly Positive,2370,47400,Unreal Engine
540,eve: valkyrie,538870,5,137,81,Mixed,218,4360,Unreal Engine
541,gears 5,1097840,6,11007,4706,Mostly Positive,15713,314260,Unreal Engine
542,deadpool,224060,8,2173,224,Very Positive,2397,47940,Unreal Engine
543,the forgotten city,874260,9,5626,182,Overwhelmingly Positive,5808,116160,Unreal Engine
544,dungeon defenders,65800,8,9148,677,Very Positive,9825,196500,Unreal Engine
545,monday night combat,63209,0,0,0,No user reviews,0,0,Unreal Engine
546,roboblitz,4300,6,29,8,Mostly Positive,37,740,Unreal Engine
547,scum,513710,6,48152,15836,Mostly Positive,63988,1279760,Unreal Engine
548,outlast,1318840,0,1,0,1 user reviews,1,20,Unreal Engine
549,observer,514900,8,3151,776,Very Positive,3927,78540,Unreal Engine
550,deus ex: invisible war,6920,5,921,711,Mixed,1632,32640,Unreal Engine
551,a way out,1222700,8,20246,3052,Very Positive,23298,465960,Unreal Engine
552,antichamber,219890,9,11211,547,Overwhelmingly Positive,11758,235160,Unreal Engine
553,the turing test,499520,8,5044,699,Very Positive,5743,114860,Unreal Engine
554,someday you'll return,840370,8,372,66,Very Positive,438,8760,Unreal Engine
555,life is strange 2,532210,8,15272,2893,Very Positive,18165,363300,Unreal Engine
556,fable anniversary,288470,8,8289,1536,Very Positive,9825,196500,Unreal Engine
557,primal carnage,215470,6,3748,1079,Mostly Positive,4827,96540,Unreal Engine
558,grip: combat racing,396900,8,2425,353,Very Positive,2778,55560,Unreal Engine
559,mighty no. 9,314710,5,954,703,Mixed,1657,33140,Unreal Engine
560,raji: an ancient epic,730390,8,1271,203,Very Positive,1474,29480,Unreal Engine
561,splitgate,677620,8,153,10,Very Positive,163,3260,Unreal Engine
562,time machine vr,356180,5,71,40,Mixed,111,2220,Unreal Engine
563,kholat,343710,5,1212,579,Mixed,1791,35820,Unreal Engine
564,evil west,1065310,0,0,0,No user reviews,0,0,Unreal Engine
565,gray dawn,747360,8,383,77,Very Positive,460,9200,Unreal Engine
566,rogue company,872200,6,37,10,Mostly Positive,47,940,Unreal Engine
567,killing floor 2,232090,8,64339,7933,Very Positive,72272,1445440,Unreal Engine
568,stray,1332010,9,73978,1948,Overwhelmingly Positive,75926,1518520,Unreal Engine
569,caffeine,865770,0,0,0,No user reviews,0,0,Unreal Engine
570,king's quest,345390,8,1107,138,Very Positive,1245,24900,Unreal Engine
571,singularity,42670,8,3943,313,Very Positive,4256,85120,Unreal Engine
572,forge,1968290,0,0,0,No user reviews,0,0,Unreal Engine
573,takedown: red sabre,236510,5,1395,2048,Mixed,3443,68860,Unreal Engine
574,submerged: hidden depths,1614270,8,113,8,Very Positive,121,2420,Unreal Engine
575,solar ash,1867530,0,0,0,No user reviews,0,0,Unreal Engine
576,nascar 21: ignition,1439300,4,100,274,Mostly Negative,374,7480,Unreal Engine
577,planet alpha,485030,6,361,100,Mostly Positive,461,9220,Unreal Engine
578,killing floor,1259,0,0,0,No user reviews,0,0,Unreal Engine
579,dreadnought,835860,0,1,2,3 user reviews,3,60,Unreal Engine
580,necromunda: underhive wars,566440,5,1330,974,Mixed,2304,46080,Unreal Engine
581,lawbreakers,350280,6,2675,1041,Mostly Positive,3716,74320,Unreal Engine
582,bravely default ii,1446650,8,848,170,Very Positive,1018,20360,Unreal Engine
583,submerged,301860,6,2897,955,Mostly Positive,3852,77040,Unreal Engine
584,hypercharge: unboxed,523660,8,2370,231,Very Positive,2601,52020,Unreal Engine
585,insurgency: sandstorm,581320,8,66925,10521,Very Positive,77446,1548920,Unreal Engine
586,the culling,437220,5,7625,5450,Mixed,13075,261500,Unreal Engine
587,papo & yo,227080,8,1008,54,Very Positive,1062,21240,Unreal Engine
588,samurai jack: battle through time,1150590,8,861,142,Very Positive,1003,20060,Unreal Engine
589,brothers in arms: road to hill 30,15190,8,1120,156,Very Positive,1276,25520,Unreal Engine
590,borderlands 2,49520,9,167830,8740,Overwhelmingly Positive,176570,3531400,Unreal Engine
591,the dark pictures anthology: house of ashes,1281590,8,3390,419,Very Positive,3809,76180,Unreal Engine
592,the park,402020,5,1560,676,Mixed,2236,44720,Unreal Engine
593,borderlands: the pre-sequel,261640,8,21627,4320,Very Positive,25947,518940,Unreal Engine
594,the ascent,979690,6,10111,3037,Mostly Positive,13148,262960,Unreal Engine
595,lost ark,1599340,6,43876,16849,Mostly Positive,60725,1214500,Unreal Engine
596,tom clancy's endwar,21809,0,0,0,No user reviews,0,0,Unreal Engine
597,smite,386360,8,1102,260,Very Positive,1362,27240,Unreal Engine
598,haunted house: cryptic graves,314850,3,1,18,Negative,19,380,Unreal Engine
599,post scriptum,736220,8,11407,2730,Very Positive,14137,282740,Unreal Engine
600,override 2: super mech league,1329790,5,51,26,Mixed,77,1540,Unreal Engine
601,juju,300840,8,59,2,Very Positive,61,1220,Unreal Engine
602,darksiders iii,606280,6,6575,2080,Mostly Positive,8655,173100,Unreal Engine
603,contrast,1670900,0,0,0,No user reviews,0,0,Unreal Engine
604,the last remnant,23319,0,0,0,No user reviews,0,0,Unreal Engine
605,bacon man: an adventure,327760,6,13,4,Mostly Positive,17,340,Unreal Engine
606,biomutant,597820,5,7602,3662,Mixed,11264,225280,Unreal Engine
607,downward,506900,6,317,130,Mostly Positive,447,8940,Unreal Engine
608,the awesome adventures of captain spirit,845070,0,0,0,No user reviews,0,0,Unreal Engine
609,rock of ages,22230,8,2540,244,Very Positive,2784,55680,Unreal Engine
610,weird west,1097350,6,1342,458,Mostly Positive,1800,36000,Unreal Engine
611,dragon ball z: kakarot,851850,8,25142,1841,Very Positive,26983,539660,Unreal Engine
612,"neko ghost, jump!",1194750,7,21,1,Positive,22,440,Unreal Engine
613,mordhau,629760,8,69047,15801,Very Positive,84848,1696960,Unreal Engine
614,apsulov: end of gods,960980,8,889,125,Very Positive,1014,20280,Unreal Engine
615,snake pass,544330,8,767,118,Very Positive,885,17700,Unreal Engine
616,thief,239160,6,11292,3823,Mostly Positive,15115,302300,Unreal Engine
617,postal 4: no regerts,707030,6,5351,1627,Mostly Positive,6978,139560,Unreal Engine
618,borderlands,8989,0,0,0,No user reviews,0,0,Unreal Engine
619,abyss odyssey,255070,5,826,388,Mixed,1214,24280,Unreal Engine
620,guilty gear xrd -sign-,376300,8,1711,162,Very Positive,1873,37460,Unreal Engine
621,agony,487720,5,941,984,Mixed,1925,38500,Unreal Engine
622,super monday night combat,104700,5,29,21,Mixed,50,1000,Unreal Engine
623,the sinking city,750130,6,1086,404,Mostly Positive,1490,29800,Unreal Engine
624,revolution 60,350200,4,14,38,Mostly Negative,52,1040,Unreal Engine
625,aliens: colonial marines,49540,5,3696,2478,Mixed,6174,123480,Unreal Engine
626,rocket league,252950,8,370971,41478,Very Positive,412449,8248980,Unreal Engine
627,thief: deadly shadows,6980,8,1531,345,Very Positive,1876,37520,Unreal Engine
628,the outlast trials,1304930,0,0,0,No user reviews,0,0,Unreal Engine
629,mutant year zero: road to eden,760060,8,10279,1094,Very Positive,11373,227460,Unreal Engine
630,chivalry 2,1824220,8,11230,2581,Very Positive,13811,276220,Unreal Engine
631,call of cthulhu,399810,6,5466,1519,Mostly Positive,6985,139700,Unreal Engine
632,remnant: from the ashes,617290,8,30420,5301,Very Positive,35721,714420,Unreal Engine
633,homefront,5975,0,0,0,No user reviews,0,0,Unreal Engine
634,cyberdimension neptunia: 4 goddesses online,632350,8,3313,463,Very Positive,3776,75520,Unreal Engine
635,tom clancy's splinter cell: double agent,13580,4,466,753,Mostly Negative,1219,24380,Unreal Engine
636,deadlight,211400,6,7074,1860,Mostly Positive,8934,178680,Unreal Engine
637,blair witch,1092660,6,3307,975,Mostly Positive,4282,85640,Unreal Engine
638,outriders,680420,5,28716,15037,Mixed,43753,875060,Unreal Engine
639,hatred,341940,8,9183,2206,Very Positive,11389,227780,Unreal Engine
640,friday the 13th: the game,438740,6,46157,11944,Mostly Positive,58101,1162020,Unreal Engine
641,gigantic,327690,7,15,0,Positive,15,300,Unreal Engine
642,marvel's midnight suns,368260,0,0,0,No user reviews,0,0,Unreal Engine
643,the dark pictures anthology: little hope,1194630,6,3129,1215,Mostly Positive,4344,86880,Unreal Engine
644,dark and light,529180,5,5296,4605,Mixed,9901,198020,Unreal Engine
645,loading human,522200,4,7,14,Mostly Negative,21,420,Unreal Engine
646,home sweet home,617160,8,2405,316,Very Positive,2721,54420,Unreal Engine
647,code vein,678960,8,27845,4427,Very Positive,32272,645440,Unreal Engine
648,pool nation fx,314000,8,289,66,Very Positive,355,7100,Unreal Engine
649,the solus project,313630,6,1874,484,Mostly Positive,2358,47160,Unreal Engine
650,sea of thieves,1172620,8,191394,19658,Very Positive,211052,4221040,Unreal Engine
651,sherlock holmes chapter one,1137300,8,1320,326,Very Positive,1646,32920,Unreal Engine
652,bright memory,955050,8,26190,2320,Very Positive,28510,570200,Unreal Engine
653,overkill's the walking dead,717690,5,2599,2514,Mixed,5113,102260,Unreal Engine
654,yaiba: ninja gaiden z,252230,5,449,245,Mixed,694,13880,Unreal Engine
655,kena: bridge of spirits,1954200,8,1546,149,Very Positive,1695,33900,Unreal Engine
656,styx: master of shadows,242640,8,5945,1200,Very Positive,7145,142900,Unreal Engine
657,days gone,1259420,8,26586,2102,Very Positive,28688,573760,Unreal Engine
658,quantum conundrum,200010,8,1280,246,Very Positive,1526,30520,Unreal Engine
659,graven,1371690,5,344,154,Mixed,498,9960,Unreal Engine
660,red orchestra: ostfront 41-45,1200,8,1073,190,Very Positive,1263,25260,Unreal Engine
661,race with ryan,1054990,6,11,4,Mostly Positive,15,300,Unreal Engine
662,blacklight: retribution,209870,5,78,80,Mixed,158,3160,Unreal Engine
663,the eternal cylinder,865680,6,77,22,Mostly Positive,99,1980,Unreal Engine
664,conan exiles,440900,6,45028,12662,Mostly Positive,57690,1153800,Unreal Engine
665,get even,299950,6,581,171,Mostly Positive,752,15040,Unreal Engine
666,x-com: enforcer,7770,5,134,109,Mixed,243,4860,Unreal Engine
667,bulletstorm,99810,6,2597,716,Mostly Positive,3313,66260,Unreal Engine
668,moss,846470,8,2104,119,Very Positive,2223,44460,Unreal Engine
669,predator: hunting grounds,1556200,6,1586,427,Mostly Positive,2013,40260,Unreal Engine
670,alien breed 2: assault,22650,6,230,74,Mostly Positive,304,6080,Unreal Engine
671,damnation,12799,0,0,0,No user reviews,0,0,Unreal Engine
672,eden star,259570,5,578,402,Mixed,980,19600,Unreal Engine
673,outlast 2,414700,8,28185,2842,Very Positive,31027,620540,Unreal Engine
674,alice: madness returns,19680,8,7990,1044,Very Positive,9034,180680,Unreal Engine
675,dragon ball fighterz,678950,8,35759,3690,Very Positive,39449,788980,Unreal Engine
676,a fisherman's tale,559330,8,693,50,Very Positive,743,14860,Unreal Engine
677,nba playgrounds,545270,6,756,270,Mostly Positive,1026,20520,Unreal Engine
678,tom clancy's splinter cell,13560,8,1882,278,Very Positive,2160,43200,Unreal Engine
679,colony ship: a post-earth role playing game,648410,8,548,97,Very Positive,645,12900,Unreal Engine
680,myst,1255560,8,765,93,Very Positive,858,17160,Unreal Engine
681,tony hawk's pro skater hd,207210,5,874,544,Mixed,1418,28360,Unreal Engine
682,alien breed 3: descent,22670,6,222,69,Mostly Positive,291,5820,Unreal Engine
683,rising storm,234510,8,84,1,Very Positive,85,1700,Unreal Engine
684,we happy few,320240,6,6960,2197,Mostly Positive,9157,183140,Unreal Engine
685,trek to yomi,1370050,5,679,305,Mixed,984,19680,Unreal Engine
686,spirit of the north,1213700,8,1904,251,Very Positive,2155,43100,Unreal Engine
687,in verbis virtus,242840,6,1117,295,Mostly Positive,1412,28240,Unreal Engine
688,system shock,482400,0,0,0,No user reviews,0,0,Unreal Engine
689,xcom: enemy within,225340,8,1241,127,Very Positive,1368,27360,Unreal Engine
690,scourge: outbreak,227560,5,136,73,Mixed,209,4180,Unreal Engine
691,dc universe online,24200,6,146,58,Mostly Positive,204,4080,Unreal Engine
692,the vanishing of ethan carter redux,400430,8,741,107,Very Positive,848,16960,Unreal Engine
693,global agenda,17020,6,293,74,Mostly Positive,367,7340,Unreal Engine
694,mortal online,287920,6,58,23,Mostly Positive,81,1620,Unreal Engine
695,backbone,865610,5,819,501,Mixed,1320,26400,Unreal Engine
696,deformers,491770,4,21,45,Mostly Negative,66,1320,Unreal Engine
697,brothers in arms: earned in blood,19800,8,575,83,Very Positive,658,13160,Unreal Engine
698,mobile forces,837940,8,55,3,Very Positive,58,1160,Unreal Engine
699,frontlines: fuel of war,9460,5,452,243,Mixed,695,13900,Unreal Engine
700,hunted: the demon's forge,22450,6,628,218,Mostly Positive,846,16920,Unreal Engine
701,q.u.b.e.,203730,9,653,34,Overwhelmingly Positive,687,13740,Unreal Engine
702,brothers in arms: hell's highway,15396,0,0,0,No user reviews,0,0,Unreal Engine
703,the suicide of rachel foster,1057750,6,2372,947,Mostly Positive,3319,66380,Unreal Engine
704,assetto corsa competizione,805550,8,13964,1315,Very Positive,15279,305580,Unreal Engine
705,the bus,491540,6,2668,762,Mostly Positive,3430,68600,Unreal Engine
706,psychonauts 2,607080,9,6110,146,Overwhelmingly Positive,6256,125120,Unreal Engine
707,aven colony,484900,6,1158,390,Mostly Positive,1548,30960,Unreal Engine
708,redout 2,1799930,6,403,115,Mostly Positive,518,10360,Unreal Engine
709,song of horror,1096570,8,1085,230,Very Positive,1315,26300,Unreal Engine
710,stela,1048600,6,488,138,Mostly Positive,626,12520,Unreal Engine
711,obliteracers,368740,5,102,55,Mixed,157,3140,Unreal Engine
712,borderlands 3,397540,8,69754,12718,Very Positive,82472,1649440,Unreal Engine
713,tell me why,1180660,8,2514,276,Very Positive,2790,55800,Unreal Engine
714,mass effect 2,24999,0,0,0,No user reviews,0,0,Unreal Engine
715,batman: arkham asylum,35019,0,0,0,No user reviews,0,0,Unreal Engine
716,wheelman,21929,0,0,0,No user reviews,0,0,Unreal Engine
717,mothergunship,574090,6,765,196,Mostly Positive,961,19220,Unreal Engine
718,tom clancy's splinter cell: chaos theory,13570,8,3163,216,Very Positive,3379,67580,Unreal Engine
719,the assembly,373650,5,88,39,Mixed,127,2540,Unreal Engine
720,bus simulator 21,976590,5,1324,625,Mixed,1949,38980,Unreal Engine
721,journey to the savage planet,973810,8,3252,422,Very Positive,3674,73480,Unreal Engine
722,danger zone,604740,5,105,46,Mixed,151,3020,Unreal Engine
723,flashback,961620,8,259,55,Very Positive,314,6280,Unreal Engine
724,draugen,770390,6,1121,360,Mostly Positive,1481,29620,Unreal Engine
725,vampyr,427290,6,10087,3116,Mostly Positive,13203,264060,Unreal Engine
726,icarus,1149460,5,14060,7502,Mixed,21562,431240,Unreal Engine
727,bus simulator 18,515180,6,5390,1439,Mostly Positive,6829,136580,Unreal Engine
728,the dark pictures anthology: man of medan,939850,6,4303,1593,Mostly Positive,5896,117920,Unreal Engine
729,spellbreak,1399780,0,0,0,No user reviews,0,0,Unreal Engine
730,the gunk,1087760,8,257,54,Very Positive,311,6220,Unreal Engine
731,ark: survival evolved,346110,8,370836,75228,Very Positive,446064,8921280,Unreal Engine
732,trials of mana,924980,8,3550,287,Very Positive,3837,76740,Unreal Engine
733,xiii,1154790,4,204,682,Mostly Negative,886,17720,Unreal Engine
734,renoir,496400,5,32,32,Mixed,64,1280,Unreal Engine
735,unmechanical,211180,8,265,23,Very Positive,288,5760,Unreal Engine
736,alpha protocol,34019,0,0,0,No user reviews,0,0,Unreal Engine
737,visage,594330,8,5019,700,Very Positive,5719,114380,Unreal Engine
738,tron: evolution,315440,5,124,84,Mixed,208,4160,Unreal Engine
739,die young,433170,8,1075,262,Very Positive,1337,26740,Unreal Engine
740,"warhammer 40,000: eternal crusade",375230,5,1990,1799,Mixed,3789,75780,Unreal Engine
741,rekoil,243320,4,84,131,Mostly Negative,215,4300,Unreal Engine
742,street fighter v,310950,6,17016,7209,Mostly Positive,24225,484500,Unreal Engine
743,sanctum 2,210770,8,6592,500,Very Positive,7092,141840,Unreal Engine
744,a hat in time,253230,9,34935,650,Overwhelmingly Positive,35585,711700,Unreal Engine
745,the battle of sol,282620,5,36,23,Mixed,59,1180,Unreal Engine
746,xing: the land beyond,299400,8,209,26,Very Positive,235,4700,Unreal Engine
747,unreal tournament 2004,13230,9,2940,72,Overwhelmingly Positive,3012,60240,Unreal Engine
748,hell let loose,686810,8,47577,6571,Very Positive,54148,1082960,Unreal Engine
749,bright memory: infinite,1178830,8,25798,2023,Very Positive,27821,556420,Unreal Engine
750,xcom: enemy unknown,200510,8,32187,1914,Very Positive,34101,682020,Unreal Engine
751,five nights at freddy's: security breach,747660,8,30924,5685,Very Positive,36609,732180,Unreal Engine
752,shape of the world,642610,8,130,29,Very Positive,159,3180,Unreal Engine
753,mortal kombat 11,976310,8,43953,6402,Very Positive,50355,1007100,Unreal Engine
754,world war 3,674020,5,17128,10658,Mixed,27786,555720,Unreal Engine
755,the callisto protocol,1544020,0,0,0,No user reviews,0,0,Unreal Engine
756,all zombies must die!,204140,6,67,22,Mostly Positive,89,1780,Unreal Engine
757,pneuma: breath of life,347440,5,85,40,Mixed,125,2500,Unreal Engine
758,magrunner: dark pulse,209630,8,255,61,Very Positive,316,6320,Unreal Engine
759,trover saves the universe,1051200,8,2294,195,Very Positive,2489,49780,Unreal Engine
760,bless unleashed,1254120,5,128,77,Mixed,205,4100,Unreal Engine
761,r-type final 2,1442820,6,373,100,Mostly Positive,473,9460,Unreal Engine
762,aquanox deep descent,254370,5,178,186,Mixed,364,7280,Unreal Engine
763,octopath traveler,921570,8,7639,1175,Very Positive,8814,176280,Unreal Engine
764,postal 2,223470,9,61162,2364,Overwhelmingly Positive,63526,1270520,Unreal Engine
765,orcs must die! 3,1522820,8,5451,1055,Very Positive,6506,130120,Unreal Engine
766,rise of the argonauts,12770,6,244,71,Mostly Positive,315,6300,Unreal Engine
767,century: age of ashes,918570,8,990,219,Very Positive,1209,24180,Unreal Engine
768,lineage ii,373700,0,0,0,No user reviews,0,0,Unreal Engine
769,i am alive,214250,5,1471,743,Mixed,2214,44280,Unreal Engine
770,legendary,16730,5,1060,846,Mixed,1906,38120,Unreal Engine
771,goat simulator,265930,8,41090,4759,Very Positive,45849,916980,Unreal Engine
772,the pathless,1492680,8,598,56,Very Positive,654,13080,Unreal Engine
